R 640 480       
NO ./textures/redbrick.xpm
SO  ./textures/eagle.xpm
WE   ./textures/bluestone.xpm
EA ./textures/bluestone.xpm
S  ./textures/barrel.xpm
F 123,155,123 
C 123, 223  , 135

      1111111111 1111111111
      1000000001 1000000001
      101100S001  10000201
      100100000111100000201111
111111111011020000111000020001
100022000011002000111011111111
11110111111111011110000010001
1111011111111101  10101010001
11200020110101011110000010201
10000200020000000110000010201
10000020120000000010101010201
11220001 101010101111001101011
11110111 111010101  101 101011
11111111 111111111  111 111111
